Test that resolving auto tracks on grid items works properly.

XXXXX
PASS
XXXXX
PASS
XXXXX
PASS
XX XX
XX XX
PASS
XX XX
XX XX
PASS
XX XX
XX XX
PASS
PASS
XXXXXXXXXX
PASS
XXXXXXXXXX XXXXXXXXX
PASS
XXXXXXXXXX XXXXXXXXX
PASS
XXXXXXXXXX XXXXXXXXX
PASS
